1111111
10P0011
1000E11
1C0C011
1C00011
1111111