11111111111111111111
10000000000000000001
100000000000000P0001
1000000000C110000001
10000000011111100001
1000000C000000000001
11110000000011100001
10000000000C11110001
11100000C00000000001
111100E0000000000111
11111111111111111111