1111111
10P0011
1000E11
1C0C011
1C00E11
1111111