111111
10P001
1000E1
1C0001
1C0001
111111